driver_id,phase,dow_name,distance_km,speeding_sum,harsh_brake_sum,rapid_accel_sum,swerve_sum,total_events_sum,rate_events_per_km
04618512580e479ca2447d2d6e3e5a01,post,Friday,5.681102755374718,0,3,2,1,6,1.0561329830416433
04618512580e479ca2447d2d6e3e5a01,post,Saturday,19.283855301209684,0,12,9,4,25,1.2964212606610743
04618512580e479ca2447d2d6e3e5a01,post,Thursday,3.725960227029789,0,2,0,0,2,0.5367743824775965
04618512580e479ca2447d2d6e3e5a01,post,Wednesday,10.362763563208786,0,5,3,2,10,0.9649935501281999
04618512580e479ca2447d2d6e3e5a01,pre,Monday,5.770869392687205,0,4,2,2,8,1.386272926248778
04618512580e479ca2447d2d6e3e5a01,pre,Saturday,8.835770198170572,0,8,8,3,19,2.1503501759171955
04618512580e479ca2447d2d6e3e5a01,pre,Sunday,2.513449896341827,0,3,3,0,6,2.3871571932794975
04618512580e479ca2447d2d6e3e5a01,pre,Thursday,11.268487395618013,0,8,6,7,21,1.8636041611198224
04618512580e479ca2447d2d6e3e5a01,pre,Tuesday,3.888325112905848,0,5,4,2,11,2.8289815487623695
04618512580e479ca2447d2d6e3e5a01,pre,Wednesday,7.47258816687515,0,9,3,1,13,1.7396917519992643
06fc09066ff54ee0b0298ef00f80d42d,post,Friday,3.852142070871915,0,1,2,0,3,0.778787475852614
06fc09066ff54ee0b0298ef00f80d42d,post,Saturday,5.247787846215746,0,4,0,0,4,0.7622259354261923
06fc09066ff54ee0b0298ef00f80d42d,post,Wednesday,3.5137739497493103,0,0,2,2,4,1.1383771572116583
06fc09066ff54ee0b0298ef00f80d42d,pre,Friday,7.589812511216371,0,5,3,1,9,1.1858000427151036
06fc09066ff54ee0b0298ef00f80d42d,pre,Monday,18.406984660719555,0,12,11,6,29,1.575488899161518
06fc09066ff54ee0b0298ef00f80d42d,pre,Saturday,2.687062477521438,0,1,0,2,3,1.1164608285428546
06fc09066ff54ee0b0298ef00f80d42d,pre,Thursday,8.012861940543868,0,6,4,3,13,1.622391611943539
06fc09066ff54ee0b0298ef00f80d42d,pre,Wednesday,5.178653877708627,0,3,3,2,8,1.5448029910698955
0f67d8169e91426a88b8a32e5eb5dce0,post,Friday,6.459530277182829,0,3,1,1,5,0.7740500911748388
0f67d8169e91426a88b8a32e5eb5dce0,post,Monday,5.523458862424418,0,1,4,3,8,1.4483678070680066
0f67d8169e91426a88b8a32e5eb5dce0,post,Saturday,3.087166290761443,0,1,0,0,1,0.32392165041208454
0f67d8169e91426a88b8a32e5eb5dce0,post,Sunday,6.013897682975177,0,1,0,3,4,0.6651260481739909
0f67d8169e91426a88b8a32e5eb5dce0,post,Tuesday,2.444285006730786,0,2,2,2,6,2.454705561535542
0f67d8169e91426a88b8a32e5eb5dce0,post,Wednesday,8.400309089142784,0,5,1,1,7,0.8333026708561649
0f67d8169e91426a88b8a32e5eb5dce0,pre,Sunday,9.265637569185927,0,2,2,8,12,1.295107855276743
0f67d8169e91426a88b8a32e5eb5dce0,pre,Thursday,2.8887916131826232,0,1,3,3,7,2.4231585165424927
0f67d8169e91426a88b8a32e5eb5dce0,pre,Tuesday,3.0964372144515044,0,0,0,0,0,0.0
0f67d8169e91426a88b8a32e5eb5dce0,pre,Wednesday,3.87448765022603,0,1,1,1,3,0.7742959252496225
17dec2934ccd42d7b02d4264290dec04,post,Friday,9.426814992706092,0,6,5,3,14,1.485125146810706
17dec2934ccd42d7b02d4264290dec04,post,Saturday,5.365986780023746,0,3,2,0,5,0.9317950649102928
17dec2934ccd42d7b02d4264290dec04,post,Thursday,24.083403598268713,0,18,11,6,35,1.453282957169561
17dec2934ccd42d7b02d4264290dec04,post,Wednesday,5.699481487046888,0,1,0,1,2,0.35090911419668
17dec2934ccd42d7b02d4264290dec04,pre,Friday,5.779243800052175,0,3,3,1,7,1.2112311302625447
17dec2934ccd42d7b02d4264290dec04,pre,Sunday,6.609528940258261,0,3,6,1,10,1.512967125250118
17dec2934ccd42d7b02d4264290dec04,pre,Thursday,21.43558870261513,0,11,14,6,31,1.4461930777864764
17dec2934ccd42d7b02d4264290dec04,pre,Tuesday,5.686362671756804,0,4,1,2,7,1.2310153966731332
17dec2934ccd42d7b02d4264290dec04,pre,Wednesday,14.324636060764876,0,10,11,3,24,1.6754352360641056
1e1f0a5baf04452ba71ce31f721700a7,post,Friday,1.8111264912910396,0,0,0,1,1,0.5521425504008625
1e1f0a5baf04452ba71ce31f721700a7,post,Saturday,5.414754626541886,0,3,3,1,7,1.2927640276971377
1e1f0a5baf04452ba71ce31f721700a7,post,Tuesday,3.1684369297857464,0,3,3,1,7,2.20929125468606
1e1f0a5baf04452ba71ce31f721700a7,post,Wednesday,14.702896215086074,0,13,7,8,28,1.9043866997626142
1e1f0a5baf04452ba71ce31f721700a7,pre,Monday,3.851616821542744,0,5,3,0,8,2.0770498132770236
1e1f0a5baf04452ba71ce31f721700a7,pre,Saturday,3.204932514588679,0,6,1,1,8,2.4961524037041136
1e1f0a5baf04452ba71ce31f721700a7,pre,Sunday,5.952413685301996,0,3,6,3,12,2.015988913813402
1e1f0a5baf04452ba71ce31f721700a7,pre,Thursday,5.3217281333254265,0,0,8,1,9,1.6911799653275608
24f36baf8aab424092875a3c5518c34c,post,Friday,11.26451320413167,0,8,2,3,13,1.154066737232087
24f36baf8aab424092875a3c5518c34c,post,Saturday,5.271049607095557,0,3,2,0,5,0.9485776785840364
24f36baf8aab424092875a3c5518c34c,post,Thursday,7.052752391620124,0,0,3,1,4,0.5671544636605539
24f36baf8aab424092875a3c5518c34c,post,Wednesday,2.885675848658,0,0,0,1,1,0.34653926928939566
24f36baf8aab424092875a3c5518c34c,pre,Friday,8.476769698325931,0,4,4,6,14,1.651572532726098
24f36baf8aab424092875a3c5518c34c,pre,Monday,8.911681433972996,0,6,3,2,11,1.2343349660217817
27efe841acc44f5099a1160226e06ccb,post,Saturday,4.520994512430495,0,1,2,1,4,0.8847610827666306
27efe841acc44f5099a1160226e06ccb,post,Sunday,11.445607827288677,0,2,4,6,12,1.0484371106433978
27efe841acc44f5099a1160226e06ccb,post,Thursday,11.999947548451985,0,9,2,3,14,1.1666717661450132
27efe841acc44f5099a1160226e06ccb,post,Tuesday,8.485440298058682,0,4,4,0,8,0.9427913837105492
27efe841acc44f5099a1160226e06ccb,post,Wednesday,2.765864681453925,0,0,0,1,1,0.36155058731012557
27efe841acc44f5099a1160226e06ccb,pre,Friday,14.272037317434059,0,7,3,0,10,0.7006708136745455
27efe841acc44f5099a1160226e06ccb,pre,Sunday,5.625997474675659,0,3,3,5,11,1.9552088406570347
27efe841acc44f5099a1160226e06ccb,pre,Thursday,10.403159769891797,0,10,6,4,20,1.9224928235633567
27efe841acc44f5099a1160226e06ccb,pre,Tuesday,4.6974922707897555,0,4,3,0,7,1.4901567892996535
348ab9962ece4e55b0ce9aa04adaf71b,post,Saturday,7.667144899546319,0,2,4,3,9,1.1738398214611216
348ab9962ece4e55b0ce9aa04adaf71b,post,Thursday,4.39406480348849,0,2,0,0,2,0.455159422867906
348ab9962ece4e55b0ce9aa04adaf71b,post,Tuesday,4.759211803926753,0,3,4,0,7,1.4708317865207021
348ab9962ece4e55b0ce9aa04adaf71b,post,Wednesday,5.128245834138705,0,1,2,1,4,0.7799938086766475
348ab9962ece4e55b0ce9aa04adaf71b,pre,Friday,12.590438829638979,0,7,9,3,19,1.5090816338563484
348ab9962ece4e55b0ce9aa04adaf71b,pre,Monday,9.773123130337144,0,6,6,4,16,1.6371429876222225
348ab9962ece4e55b0ce9aa04adaf71b,pre,Thursday,5.7839474652401055,0,3,9,4,16,2.7662768543724665
348ab9962ece4e55b0ce9aa04adaf71b,pre,Tuesday,7.167742411780269,0,6,6,5,17,2.371737016115465
3851f86078c147048498bac873d32bb9,post,Friday,4.582925416470641,0,2,0,2,4,0.872804952405366
3851f86078c147048498bac873d32bb9,post,Monday,3.614237150356708,0,3,2,1,6,1.6601013576012378
3851f86078c147048498bac873d32bb9,post,Sunday,1.36920974478061,0,2,0,0,2,1.460696586205251
3851f86078c147048498bac873d32bb9,post,Tuesday,5.287622033477899,0,2,4,2,8,1.5129674453561597
3851f86078c147048498bac873d32bb9,post,Wednesday,10.800261564889556,0,5,0,4,9,0.8333131513460743
3851f86078c147048498bac873d32bb9,pre,Monday,7.7193959709504085,0,10,5,3,18,2.33178866166958
3851f86078c147048498bac873d32bb9,pre,Tuesday,15.608498965930666,0,16,13,10,39,2.4986387278576214
3851f86078c147048498bac873d32bb9,pre,Wednesday,5.114153322972063,0,5,5,1,11,2.15089366808569
39db2e32f4444b148643a4108c7fc103,post,Friday,3.584986761689647,0,1,1,2,4,1.1157642317526306
39db2e32f4444b148643a4108c7fc103,post,Monday,3.365507927899737,0,1,4,0,5,1.4856598490083712
39db2e32f4444b148643a4108c7fc103,post,Thursday,16.95636582022708,0,5,5,9,19,1.1205231239665217
39db2e32f4444b148643a4108c7fc103,post,Tuesday,2.7462114089893688,0,2,2,0,4,1.4565521018908143
39db2e32f4444b148643a4108c7fc103,post,Wednesday,4.170805876043371,0,4,1,3,8,1.9180945452175273
39db2e32f4444b148643a4108c7fc103,pre,Friday,2.8047791363339467,0,0,0,1,1,0.3565343121123875
39db2e32f4444b148643a4108c7fc103,pre,Tuesday,5.748342041000516,0,7,4,5,16,2.783411266392762
39db2e32f4444b148643a4108c7fc103,pre,Wednesday,10.358208351426027,0,6,6,5,17,1.6412104703087564
3e5ec44cde6d4304ab58443d90368274,post,Friday,11.08791496466416,0,7,7,6,20,1.803765637068608
3e5ec44cde6d4304ab58443d90368274,post,Monday,0.0,0,0,0,0,0,0.0
3e5ec44cde6d4304ab58443d90368274,post,Saturday,4.532916133175494,0,1,6,0,7,1.5442597644303233
3e5ec44cde6d4304ab58443d90368274,post,Sunday,2.1075155777400223,0,0,0,1,1,0.4744923409165697
3e5ec44cde6d4304ab58443d90368274,post,Thursday,11.923007731276975,0,2,7,8,17,1.4258147258769973
3e5ec44cde6d4304ab58443d90368274,post,Tuesday,0.0,0,0,0,0,0,0.0
3e5ec44cde6d4304ab58443d90368274,post,Wednesday,0.0,0,0,0,0,0,0.0
3e5ec44cde6d4304ab58443d90368274,pre,Saturday,3.2395493205357453,0,2,2,3,7,2.160794390635289
3e5ec44cde6d4304ab58443d90368274,pre,Sunday,11.198880216528515,0,7,5,6,18,1.6073035564246556
3e5ec44cde6d4304ab58443d90368274,pre,Tuesday,11.653239986269703,0,4,5,2,11,0.9439434880737566
3e5ec44cde6d4304ab58443d90368274,pre,Wednesday,2.831150856237679,0,1,2,0,3,1.0596397551159478
3e7365e2a1894d95b115a245ed9af0ec,post,Friday,15.634111265184421,0,7,8,10,25,1.5990675501761626
3e7365e2a1894d95b115a245ed9af0ec,post,Saturday,2.326159734442032,0,1,2,1,4,1.7195723667529934
3e7365e2a1894d95b115a245ed9af0ec,post,Sunday,8.990712920054602,0,3,3,0,6,0.6673553091230903
3e7365e2a1894d95b115a245ed9af0ec,post,Thursday,4.12633379592621,0,2,2,0,4,0.9693835248978317
3e7365e2a1894d95b115a245ed9af0ec,post,Tuesday,2.171094255003969,0,1,0,0,1,0.4605972300351243
3e7365e2a1894d95b115a245ed9af0ec,post,Wednesday,4.984915121825115,0,0,1,0,1,0.20060522106419984
3e7365e2a1894d95b115a245ed9af0ec,pre,Friday,4.589625546227706,0,2,5,2,9,1.9609442882322414
3e7365e2a1894d95b115a245ed9af0ec,pre,Saturday,4.3135833841479965,0,2,3,2,7,1.6227807316126832
3e7365e2a1894d95b115a245ed9af0ec,pre,Thursday,10.619714657670519,0,4,5,2,11,1.0358093747890678
3e7365e2a1894d95b115a245ed9af0ec,pre,Tuesday,18.059785222399903,0,10,10,10,30,1.6611493232372674
3e7365e2a1894d95b115a245ed9af0ec,pre,Wednesday,10.175338649450678,0,1,4,5,10,0.9827682738146367
3ff40565ba464936b28420c370651622,post,Friday,5.655413408864373,0,2,3,0,5,0.8841086651884602
3ff40565ba464936b28420c370651622,post,Thursday,13.374589190100366,0,4,7,5,16,1.1962984262606673
3ff40565ba464936b28420c370651622,post,Wednesday,2.4627444679077555,0,2,3,1,6,2.436306355850775
3ff40565ba464936b28420c370651622,pre,Friday,15.299853483694463,0,3,5,5,13,0.8496813393575638
3ff40565ba464936b28420c370651622,pre,Monday,9.31144714622171,0,4,6,2,12,1.288736306135746
3ff40565ba464936b28420c370651622,pre,Saturday,6.962686847951714,0,9,4,2,15,2.1543407491337496
3ff40565ba464936b28420c370651622,pre,Sunday,5.031273542894086,0,4,3,4,11,2.186325173183207
3ff40565ba464936b28420c370651622,pre,Wednesday,2.604008577393645,0,0,0,1,1,0.3840233126270655
40eac30faba0435da0d7213f8cfc9c32,post,Sunday,12.830447080825934,0,9,8,2,19,1.480852528388817
40eac30faba0435da0d7213f8cfc9c32,post,Thursday,2.8537449657804785,0,1,0,1,2,0.7008334746034373
40eac30faba0435da0d7213f8cfc9c32,post,Wednesday,8.166616625016623,0,4,3,1,8,0.9795978392684396
40eac30faba0435da0d7213f8cfc9c32,pre,Monday,3.495022510495415,0,3,1,0,4,1.1444847602520893
40eac30faba0435da0d7213f8cfc9c32,pre,Saturday,1.4453287967738793,0,0,2,1,3,2.0756522714390697
40eac30faba0435da0d7213f8cfc9c32,pre,Sunday,5.034294992059698,0,1,1,2,4,0.7945501815664294
40eac30faba0435da0d7213f8cfc9c32,pre,Thursday,3.134012526229573,0,3,1,1,5,1.5953988563074872
40eac30faba0435da0d7213f8cfc9c32,pre,Tuesday,1.2953935046798677,0,1,0,1,2,1.5439323979737436
43b16573fdbc466184844ca9d858b626,post,Thursday,7.704598225105751,0,7,1,0,8,1.038340970711707
43b16573fdbc466184844ca9d858b626,post,Tuesday,1.9925411252572875,0,3,2,2,7,3.5131018934909677
43b16573fdbc466184844ca9d858b626,post,Wednesday,6.8249592998166975,0,0,1,3,4,0.5860840811325323
43b16573fdbc466184844ca9d858b626,pre,Saturday,9.377403098692128,0,4,2,3,9,0.9597539857548872
43b16573fdbc466184844ca9d858b626,pre,Sunday,8.93231807191657,0,5,6,3,14,1.5673423054667466
43b16573fdbc466184844ca9d858b626,pre,Thursday,7.727918662352645,0,4,2,1,7,0.9058066351165449
43b16573fdbc466184844ca9d858b626,pre,Tuesday,6.084468125738167,0,1,1,2,4,0.6574116122129772
446b1e2317304addbacd77c47114dac3,post,Friday,2.3138024050377517,0,1,1,0,2,0.8643780452667341
446b1e2317304addbacd77c47114dac3,post,Monday,8.10826456206891,0,0,5,0,5,0.6166547677033613
446b1e2317304addbacd77c47114dac3,post,Saturday,6.294255460883629,0,2,2,0,4,0.6355001040009352
446b1e2317304addbacd77c47114dac3,post,Sunday,10.724646842783233,0,8,2,2,12,1.1189179630725994
446b1e2317304addbacd77c47114dac3,post,Tuesday,9.644097490319036,0,3,5,1,9,0.9332132953896831
446b1e2317304addbacd77c47114dac3,post,Wednesday,13.303113781023795,0,8,2,3,13,0.9772148245881975
446b1e2317304addbacd77c47114dac3,pre,Friday,6.53437480604609,0,2,1,1,4,0.6121473161133797
446b1e2317304addbacd77c47114dac3,pre,Monday,3.97584679804432,0,4,3,0,7,1.7606312203586996
446b1e2317304addbacd77c47114dac3,pre,Wednesday,4.818714016247389,0,1,1,2,4,0.8300969898842494
54767952a9c2411ab0d1686941ebbd26,post,Friday,4.413637718829016,0,0,3,1,4,0.9062819050452653
54767952a9c2411ab0d1686941ebbd26,post,Monday,10.748518824032953,0,6,6,2,14,1.3025050455042193
54767952a9c2411ab0d1686941ebbd26,post,Sunday,3.095539082755853,0,1,1,1,3,0.969136528339097
54767952a9c2411ab0d1686941ebbd26,post,Tuesday,5.093280685232944,0,2,2,3,7,1.3743597560400014
54767952a9c2411ab0d1686941ebbd26,pre,Friday,10.131414591039121,0,8,7,4,19,1.8753550976785442
54767952a9c2411ab0d1686941ebbd26,pre,Monday,2.8555687295397165,0,0,2,2,4,1.4007717477158226
54767952a9c2411ab0d1686941ebbd26,pre,Saturday,5.250372681344053,0,2,6,3,11,2.0950893712908947
54767952a9c2411ab0d1686941ebbd26,pre,Sunday,2.84011099144469,0,2,1,1,4,1.4083956620178795
54767952a9c2411ab0d1686941ebbd26,pre,Thursday,3.224455866145723,0,1,3,1,5,1.550649228136787
54767952a9c2411ab0d1686941ebbd26,pre,Tuesday,6.325186827059918,0,5,3,1,9,1.4228828722492284
54767952a9c2411ab0d1686941ebbd26,pre,Wednesday,3.104300170662572,0,2,5,0,7,2.254936576737662
58a1c1708edb4a75be19901e378e0285,post,Saturday,8.22158487881592,0,8,0,3,11,1.337941548027201
58a1c1708edb4a75be19901e378e0285,post,Sunday,5.776227700304897,0,4,0,1,5,0.8656168453567153
58a1c1708edb4a75be19901e378e0285,post,Tuesday,2.711719341408953,0,3,1,4,8,2.9501578123654073
58a1c1708edb4a75be19901e378e0285,pre,Friday,6.44954149681778,0,3,3,1,7,1.085348470655444
58a1c1708edb4a75be19901e378e0285,pre,Monday,10.737818726595862,0,1,2,4,7,0.6519014874652446
58a1c1708edb4a75be19901e378e0285,pre,Saturday,5.959111307419359,0,3,1,1,5,0.8390512850086853
58a1c1708edb4a75be19901e378e0285,pre,Sunday,13.835450732463041,0,4,2,5,11,0.7950590271836946
58a1c1708edb4a75be19901e378e0285,pre,Thursday,6.806813066362887,0,0,3,3,6,0.8814697776335446
5952789bad7b454e96bce0fed9c90344,post,Friday,3.407117780581057,0,2,0,0,2,0.5870064168016275
5952789bad7b454e96bce0fed9c90344,post,Saturday,2.356134419627491,0,0,0,1,1,0.42442400215778087
5952789bad7b454e96bce0fed9c90344,post,Sunday,5.418364938508905,0,1,2,0,3,0.5536725624881181
5952789bad7b454e96bce0fed9c90344,post,Tuesday,4.625721594131338,0,3,0,1,4,0.8647299493931514
5952789bad7b454e96bce0fed9c90344,pre,Saturday,10.649182073519787,0,9,7,3,19,1.7841745843791443
5952789bad7b454e96bce0fed9c90344,pre,Sunday,13.425909541701404,0,7,2,6,15,1.1172427427288563
5952789bad7b454e96bce0fed9c90344,pre,Tuesday,6.031170535011852,0,1,2,2,5,0.829026466914548
61766dd5d46f40f499602f7f5fb97620,post,Monday,4.573680675861402,0,4,3,0,7,1.5304960044421176
61766dd5d46f40f499602f7f5fb97620,post,Thursday,8.954524825521576,0,0,1,1,2,0.22335076835118448
61766dd5d46f40f499602f7f5fb97620,post,Wednesday,3.033779714856073,0,2,1,1,4,1.3184872917478012
61766dd5d46f40f499602f7f5fb97620,pre,Friday,3.130048818046042,0,0,1,1,2,0.638967669919128
61766dd5d46f40f499602f7f5fb97620,pre,Saturday,7.008943083387472,0,3,7,1,11,1.5694235021071994
61766dd5d46f40f499602f7f5fb97620,pre,Sunday,11.390656199891666,0,11,4,1,16,1.4046600756989025
61766dd5d46f40f499602f7f5fb97620,pre,Tuesday,5.730325381737073,0,3,2,2,7,1.2215711209540498
63abe8bd8a454c878093476d92bbefc4,post,Friday,2.933539098040514,0,1,1,3,5,1.7044258940812476
63abe8bd8a454c878093476d92bbefc4,post,Saturday,3.0906657135127125,0,0,2,0,2,0.6471097767887972
63abe8bd8a454c878093476d92bbefc4,post,Thursday,6.619625378866784,0,3,1,4,8,1.2085276042266795
63abe8bd8a454c878093476d92bbefc4,post,Tuesday,3.970609304050944,0,1,1,0,2,0.5037010309625617
63abe8bd8a454c878093476d92bbefc4,pre,Monday,1.9406584494304224,0,0,0,0,0,0.0
63abe8bd8a454c878093476d92bbefc4,pre,Sunday,7.88584233817498,0,5,6,1,12,1.5217144200193533
63abe8bd8a454c878093476d92bbefc4,pre,Thursday,4.043763306777819,0,3,2,1,6,1.4837663692984453
63abe8bd8a454c878093476d92bbefc4,pre,Tuesday,17.899711337586574,0,8,6,8,22,1.2290700997956021
63abe8bd8a454c878093476d92bbefc4,pre,Wednesday,8.952104321950088,0,6,4,5,15,1.6755836907776858
6651a7b1ae6342e0bca120ed8da2207e,post,Friday,4.290113120827805,0,3,3,2,8,1.8647526940866184
6651a7b1ae6342e0bca120ed8da2207e,post,Monday,9.226617863476498,0,5,3,1,9,0.9754386854609463
6651a7b1ae6342e0bca120ed8da2207e,post,Sunday,12.934572238360165,0,8,5,2,15,1.1596827265392187
6651a7b1ae6342e0bca120ed8da2207e,post,Thursday,5.976197002953571,0,4,2,2,8,1.3386439563565626
6651a7b1ae6342e0bca120ed8da2207e,post,Tuesday,2.171604907423399,0,1,1,0,2,0.9209778413942674
6651a7b1ae6342e0bca120ed8da2207e,post,Wednesday,10.742088220048656,0,5,3,2,10,0.9309176945071398
6651a7b1ae6342e0bca120ed8da2207e,pre,Monday,9.209531863762647,0,3,5,2,10,1.0858315219417025
6651a7b1ae6342e0bca120ed8da2207e,pre,Sunday,8.77994278492878,0,1,2,2,5,0.5694797930326785
6900c77cf75e4db28adbac15140e3931,post,Monday,8.539181269121954,0,6,5,5,16,1.8737159331488473
6900c77cf75e4db28adbac15140e3931,post,Saturday,5.1657730242159525,0,4,4,0,8,1.5486549568666383
6900c77cf75e4db28adbac15140e3931,post,Thursday,11.11976055154419,0,9,5,1,15,1.3489499104292282
6900c77cf75e4db28adbac15140e3931,pre,Friday,5.480143991410175,0,5,3,0,8,1.4598156567673333
6900c77cf75e4db28adbac15140e3931,pre,Monday,12.151150478913422,0,8,3,1,12,0.987560809227429
6900c77cf75e4db28adbac15140e3931,pre,Saturday,3.6956959951373567,0,0,4,2,6,1.6235101609803813
6900c77cf75e4db28adbac15140e3931,pre,Tuesday,4.402161427614783,0,1,4,0,5,1.1358056905035268
6900c77cf75e4db28adbac15140e3931,pre,Wednesday,17.73419823728176,0,6,14,5,25,1.4097056808265338
6d3af7163bb74225818446ad551185a6,post,Friday,18.047407817334403,0,10,6,7,23,1.2744212483472928
6d3af7163bb74225818446ad551185a6,post,Monday,7.37329780032781,0,5,2,0,7,0.9493716637470938
6d3af7163bb74225818446ad551185a6,post,Saturday,1.875169515102289,0,1,0,0,1,0.5332851200631058
6d3af7163bb74225818446ad551185a6,post,Thursday,4.297226546581183,0,1,3,0,4,0.9308329352992448
6d3af7163bb74225818446ad551185a6,post,Tuesday,1.8851259580274744,0,1,1,0,2,1.0609370644350606
6d3af7163bb74225818446ad551185a6,post,Wednesday,4.457068417489471,0,2,1,0,3,0.6730881644598598
6d3af7163bb74225818446ad551185a6,pre,Monday,12.56679110822814,0,7,7,7,21,1.6710709853568104
6d3af7163bb74225818446ad551185a6,pre,Saturday,10.410417055993493,0,9,6,2,17,1.6329797268028514
6d3af7163bb74225818446ad551185a6,pre,Thursday,6.108210126993249,0,5,3,3,11,1.8008548775015245
6d3af7163bb74225818446ad551185a6,pre,Wednesday,8.392249953013923,0,8,8,1,17,2.0256784646761816
7c9d6a121cef4c908c451171d246a97d,post,Monday,0.0,0,0,0,0,0,0.0
7c9d6a121cef4c908c451171d246a97d,post,Sunday,9.255652497230706,0,1,2,1,4,0.43216834266377235
7c9d6a121cef4c908c451171d246a97d,post,Thursday,8.446288449011465,0,6,6,0,12,1.4207423855391126
7c9d6a121cef4c908c451171d246a97d,post,Tuesday,5.444729597334061,0,0,1,1,2,0.3673276999796782
7c9d6a121cef4c908c451171d246a97d,pre,Friday,9.804890206203954,0,9,6,3,18,1.835818619224381
7c9d6a121cef4c908c451171d246a97d,pre,Monday,12.028275292939728,0,6,4,1,11,0.9145118258522651
7c9d6a121cef4c908c451171d246a97d,pre,Saturday,6.717065704796054,0,3,2,2,7,1.0421217102286089
7c9d6a121cef4c908c451171d246a97d,pre,Thursday,8.24866152511654,0,7,5,3,15,1.8184768467376375
7c9d6a121cef4c908c451171d246a97d,pre,Tuesday,8.063519485115943,0,2,4,1,7,0.8681072840365746
80be0493a84549a69b4069f25939d72b,post,Friday,6.035166027263129,0,5,2,1,8,1.325564195559985
80be0493a84549a69b4069f25939d72b,post,Monday,9.066671846536234,0,5,6,1,12,1.3235286556206833
80be0493a84549a69b4069f25939d72b,post,Saturday,3.1415596303941213,0,1,4,1,6,1.909879393009413
80be0493a84549a69b4069f25939d72b,post,Thursday,2.003250703069236,0,0,0,0,0,0.0
80be0493a84549a69b4069f25939d72b,post,Wednesday,9.290149540018696,0,6,1,0,7,0.7534862565824654
80be0493a84549a69b4069f25939d72b,pre,Friday,6.847487739216722,0,2,5,6,13,1.8985065026910233
80be0493a84549a69b4069f25939d72b,pre,Saturday,4.574692935404887,0,0,3,3,6,1.311563439277912
80be0493a84549a69b4069f25939d72b,pre,Thursday,7.072509444907112,0,6,4,2,12,1.6967103534433814
8c8b69c30829410ba97add4d99084ca2,post,Friday,10.388100853061975,0,8,4,1,13,1.2514318241498539
8c8b69c30829410ba97add4d99084ca2,post,Monday,3.3727824218326403,0,2,3,5,10,2.9649110880287335
8c8b69c30829410ba97add4d99084ca2,post,Saturday,3.897923165532223,0,4,1,2,7,1.7958281122363322
8c8b69c30829410ba97add4d99084ca2,post,Sunday,4.877541750107246,0,1,1,2,4,0.8200852406669915
8c8b69c30829410ba97add4d99084ca2,post,Thursday,2.536033451817251,0,0,1,2,3,1.1829496956557428
8c8b69c30829410ba97add4d99084ca2,post,Tuesday,5.093809456972629,0,2,3,1,6,1.177900361346838
8c8b69c30829410ba97add4d99084ca2,pre,Monday,4.691019813802859,0,5,3,2,10,2.1317326289213265
8c8b69c30829410ba97add4d99084ca2,pre,Saturday,8.242766320580067,0,3,6,2,11,1.3345034387952779
8c8b69c30829410ba97add4d99084ca2,pre,Sunday,5.08580694415428,0,4,2,3,9,1.7696306798166543
8c8b69c30829410ba97add4d99084ca2,pre,Thursday,3.6811291965406303,0,1,2,1,4,1.086623094826183
8c8b69c30829410ba97add4d99084ca2,pre,Wednesday,3.115517492730007,0,2,4,3,9,2.8887656772915915
8d3cc8f598564bd5b108ae140e61e94d,post,Monday,11.648818241505666,0,7,7,6,20,1.7169123584346444
8d3cc8f598564bd5b108ae140e61e94d,post,Saturday,10.929697082599807,0,6,3,5,14,1.2809138162015623
8d3cc8f598564bd5b108ae140e61e94d,post,Tuesday,3.917117982179648,0,4,0,1,5,1.276448660149315
8d3cc8f598564bd5b108ae140e61e94d,post,Wednesday,5.138820987174753,0,0,1,3,4,0.7783886634663917
8d3cc8f598564bd5b108ae140e61e94d,pre,Friday,7.781987449921818,0,4,1,0,5,0.6425093887873377
8d3cc8f598564bd5b108ae140e61e94d,pre,Monday,1.697247479275399,0,1,3,1,5,2.945946340208816
8d3cc8f598564bd5b108ae140e61e94d,pre,Saturday,8.894754002592538,0,4,7,0,11,1.2366840046159624
8d3cc8f598564bd5b108ae140e61e94d,pre,Sunday,3.7278377810206536,0,2,3,4,9,2.4142681438074454
8d3cc8f598564bd5b108ae140e61e94d,pre,Tuesday,1.892054890048978,0,1,0,0,1,0.5285258928054216
8d7f675ff2624ffb9465426c5eb78be3,post,Saturday,3.5474858885499243,0,0,2,1,3,0.845669325897244
8d7f675ff2624ffb9465426c5eb78be3,post,Thursday,6.3640131839832215,0,1,2,2,5,0.7856677626916089
8d7f675ff2624ffb9465426c5eb78be3,post,Tuesday,6.614217760037533,0,4,4,1,9,1.360705124402939
8d7f675ff2624ffb9465426c5eb78be3,pre,Monday,3.048234668057431,0,1,0,1,2,0.6561174639728619
8d7f675ff2624ffb9465426c5eb78be3,pre,Saturday,4.122953020622052,0,0,3,0,3,0.7276338063991264
8d7f675ff2624ffb9465426c5eb78be3,pre,Thursday,25.956938744962493,0,12,23,7,42,1.6180644571637328
8d7f675ff2624ffb9465426c5eb78be3,pre,Tuesday,11.763811719742382,0,6,2,6,14,1.190090451422712
8d7f675ff2624ffb9465426c5eb78be3,pre,Wednesday,3.753561626283333,0,1,0,1,2,0.5328272715693605
9aafce90055a47a18e0c79089469f85a,post,Monday,7.146617422460372,0,6,1,1,8,1.1194106983896492
9aafce90055a47a18e0c79089469f85a,post,Saturday,4.755107963316668,0,2,1,2,5,1.051500836273867
9aafce90055a47a18e0c79089469f85a,post,Sunday,1.839440937008664,0,2,2,0,4,2.17457376288737
9aafce90055a47a18e0c79089469f85a,post,Thursday,9.251880670445557,0,6,1,4,11,1.18894745747626
9aafce90055a47a18e0c79089469f85a,post,Tuesday,5.519737115778667,0,2,3,1,6,1.0870082893709663
9aafce90055a47a18e0c79089469f85a,pre,Friday,4.080470941730341,0,1,1,2,4,0.9802790063011166
9aafce90055a47a18e0c79089469f85a,pre,Monday,2.8864758852745283,0,0,0,2,2,0.6928864398982439
9aafce90055a47a18e0c79089469f85a,pre,Saturday,3.968857919446701,0,1,1,3,5,1.2598082625988916
9aafce90055a47a18e0c79089469f85a,pre,Tuesday,4.724547013981891,0,0,2,0,2,0.42332100708939335
a3b15fad27184a99ae226cc8dba8efcb,post,Monday,3.20638483487983,0,0,1,0,1,0.31187772257458246
a3b15fad27184a99ae226cc8dba8efcb,post,Saturday,3.1792626893494083,0,1,3,0,4,1.2581533490139325
a3b15fad27184a99ae226cc8dba8efcb,post,Thursday,17.24147422671303,0,8,9,6,23,1.3339926561711883
a3b15fad27184a99ae226cc8dba8efcb,post,Tuesday,3.68114720806824,0,1,1,1,3,0.814963333556637
a3b15fad27184a99ae226cc8dba8efcb,post,Wednesday,3.1255242993900696,0,1,0,0,1,0.3199463207485365
a3b15fad27184a99ae226cc8dba8efcb,pre,Friday,3.9108335748300735,0,2,2,0,4,1.0227998516080554
a3b15fad27184a99ae226cc8dba8efcb,pre,Saturday,3.3562075032132075,0,2,2,1,5,1.4897767778699733
a3b15fad27184a99ae226cc8dba8efcb,pre,Sunday,7.900330094859285,0,2,9,2,13,1.6455008643827491
a3b15fad27184a99ae226cc8dba8efcb,pre,Tuesday,3.971292943382432,0,4,4,2,10,2.518071606040423
a3b15fad27184a99ae226cc8dba8efcb,pre,Wednesday,10.687908306119823,0,7,3,5,15,1.40345515421489
a4df00ef510a44b59fcf6e1910eb6fd2,post,Friday,4.071079735441183,0,2,0,1,3,0.7369052425780823
a4df00ef510a44b59fcf6e1910eb6fd2,post,Monday,4.923849419630335,0,1,0,4,5,1.0154656598688963
a4df00ef510a44b59fcf6e1910eb6fd2,post,Sunday,6.48770999580355,0,3,6,2,11,1.6955135181928813
a4df00ef510a44b59fcf6e1910eb6fd2,post,Tuesday,5.280064066665616,0,1,0,1,2,0.3787832826928195
a4df00ef510a44b59fcf6e1910eb6fd2,post,Wednesday,8.49779813138191,0,2,0,4,6,0.7060652544618969
a4df00ef510a44b59fcf6e1910eb6fd2,pre,Monday,16.09101463447702,0,11,6,5,22,1.3672226705245942
a4df00ef510a44b59fcf6e1910eb6fd2,pre,Saturday,7.96219191261083,0,3,3,2,8,1.0047484521604269
a4df00ef510a44b59fcf6e1910eb6fd2,pre,Thursday,4.789239585081867,0,1,0,0,1,0.2088014145533515
a4df00ef510a44b59fcf6e1910eb6fd2,pre,Tuesday,7.531013080171313,0,3,3,1,7,0.9294898210216316
a4df00ef510a44b59fcf6e1910eb6fd2,pre,Wednesday,3.531050679260955,0,2,1,1,4,1.1328073039260924
b32c79530f6049bd94d61b63a5412020,post,Friday,2.4476255676082648,0,2,0,1,3,1.2256776688811502
b32c79530f6049bd94d61b63a5412020,post,Monday,7.9023333071747075,0,3,3,2,8,1.012359222147289
b32c79530f6049bd94d61b63a5412020,post,Saturday,8.217654103511826,0,4,1,1,6,0.7301353798081975
b32c79530f6049bd94d61b63a5412020,pre,Friday,5.147299464133017,0,3,2,2,7,1.3599364188496932
b32c79530f6049bd94d61b63a5412020,pre,Monday,2.420896292282926,0,3,0,2,5,2.0653507611781907
b32c79530f6049bd94d61b63a5412020,pre,Saturday,3.136918069868187,0,5,1,2,8,2.5502738107330165
b32c79530f6049bd94d61b63a5412020,pre,Sunday,6.784030818696352,0,3,4,4,11,1.6214548981240928
b32c79530f6049bd94d61b63a5412020,pre,Thursday,11.963604482989272,0,3,4,2,9,0.7522816399352602
b32c79530f6049bd94d61b63a5412020,pre,Tuesday,10.768476355304864,0,5,14,2,21,1.9501366123773667
b52a27b2f0da4fefa31d352987994498,post,Friday,5.697037118408934,0,2,2,1,5,0.8776491878284265
b52a27b2f0da4fefa31d352987994498,post,Monday,21.15818477209541,0,6,8,2,16,0.7562085392647525
b52a27b2f0da4fefa31d352987994498,post,Sunday,4.672068237927124,0,0,2,2,4,0.8561518788464222
b52a27b2f0da4fefa31d352987994498,post,Thursday,4.883398042119607,0,0,0,1,1,0.2047754435282438
b52a27b2f0da4fefa31d352987994498,post,Tuesday,3.8219869243081215,0,1,2,0,3,0.784932041739802
b52a27b2f0da4fefa31d352987994498,pre,Monday,6.816275909864348,0,5,2,1,8,1.1736614106865297
b52a27b2f0da4fefa31d352987994498,pre,Saturday,5.788612141759336,0,1,1,2,4,0.6910119216908317
b52a27b2f0da4fefa31d352987994498,pre,Sunday,23.82275138915529,0,13,11,17,41,1.7210438597224427
b52a27b2f0da4fefa31d352987994498,pre,Wednesday,5.99246382127509,0,4,4,2,10,1.668762682303884
b69a8ff4e1334b9daa098dda8d1c9f13,post,Saturday,7.082449326083587,0,2,2,1,5,0.705970458776988
b69a8ff4e1334b9daa098dda8d1c9f13,post,Sunday,2.2978520760487795,0,1,0,0,1,0.4351890230112322
b69a8ff4e1334b9daa098dda8d1c9f13,post,Thursday,4.5985107028169585,0,1,0,1,2,0.43492341961384123
b69a8ff4e1334b9daa098dda8d1c9f13,post,Tuesday,12.802923134222524,0,10,1,2,13,1.0153931148153725
b69a8ff4e1334b9daa098dda8d1c9f13,pre,Friday,3.432294763900385,0,3,1,2,6,1.7481016091933
b69a8ff4e1334b9daa098dda8d1c9f13,pre,Monday,2.529929218502004,0,2,3,0,5,1.9763398767972444
b69a8ff4e1334b9daa098dda8d1c9f13,pre,Saturday,10.438319315511194,0,8,7,2,17,1.62861467312446
b69a8ff4e1334b9daa098dda8d1c9f13,pre,Sunday,10.70947307194924,0,6,10,5,21,1.9608807883372148
b69a8ff4e1334b9daa098dda8d1c9f13,pre,Thursday,2.457405383175545,0,0,1,1,2,0.8138665332520474
b69a8ff4e1334b9daa098dda8d1c9f13,pre,Wednesday,6.995307817636164,0,1,3,4,8,1.1436237272977272
b9c40703dcfd40fbafcac4dc20a63295,post,Saturday,4.124521446524053,0,4,2,1,7,1.6971665902960116
b9c40703dcfd40fbafcac4dc20a63295,post,Sunday,11.275953856513507,0,5,3,3,11,0.9755272272283996
b9c40703dcfd40fbafcac4dc20a63295,post,Thursday,7.398362973583566,0,5,1,3,9,1.2164853268398974
b9c40703dcfd40fbafcac4dc20a63295,post,Tuesday,10.03178992856325,0,8,5,0,13,1.295880405448428
b9c40703dcfd40fbafcac4dc20a63295,post,Wednesday,7.484612769430946,0,1,3,3,7,0.935252125345719
b9c40703dcfd40fbafcac4dc20a63295,pre,Friday,7.317460838560751,0,4,3,4,11,1.5032536890438017
b9c40703dcfd40fbafcac4dc20a63295,pre,Monday,4.2875851438742565,0,4,1,4,9,2.0990836795062715
b9c40703dcfd40fbafcac4dc20a63295,pre,Thursday,3.2087891342434087,0,3,4,0,7,2.181508259703862
b9c40703dcfd40fbafcac4dc20a63295,pre,Tuesday,5.971757276565084,0,2,8,3,13,2.1769136617484084
b9c40703dcfd40fbafcac4dc20a63295,pre,Wednesday,5.121391028790321,0,3,2,5,10,1.9525945087543943
ba9e2cf437e640f2aa38c5cb08ae028f,post,Friday,14.493824650481361,0,7,7,4,18,1.241908221885532
ba9e2cf437e640f2aa38c5cb08ae028f,post,Monday,9.373710610820442,0,3,2,3,8,0.8534507125454979
ba9e2cf437e640f2aa38c5cb08ae028f,post,Saturday,4.166534279687542,0,0,1,2,3,0.7200228771968671
ba9e2cf437e640f2aa38c5cb08ae028f,post,Wednesday,13.69003463410163,0,7,4,5,16,1.1687333471125256
ba9e2cf437e640f2aa38c5cb08ae028f,pre,Friday,3.5956682891924427,0,1,3,3,7,1.94678692165237
ba9e2cf437e640f2aa38c5cb08ae028f,pre,Monday,11.215518529054343,0,2,1,4,7,0.6241352088952608
ba9e2cf437e640f2aa38c5cb08ae028f,pre,Saturday,13.516763860162266,0,8,2,4,14,1.0357508753453901
ba9e2cf437e640f2aa38c5cb08ae028f,pre,Sunday,2.07901356090216,0,0,1,2,3,1.4429920306523591
ba9e2cf437e640f2aa38c5cb08ae028f,pre,Wednesday,3.372026665186763,0,0,4,1,5,1.4827877998773389
be38347662f84cfaaf138568c7af23dc,post,Friday,13.226074496599304,0,8,4,8,20,1.512164475191971
be38347662f84cfaaf138568c7af23dc,post,Monday,4.189987304526319,0,1,1,2,4,0.9546568305061255
be38347662f84cfaaf138568c7af23dc,post,Saturday,14.854320777316932,0,14,4,4,22,1.4810505528865898
be38347662f84cfaaf138568c7af23dc,post,Sunday,9.510627901408668,0,4,3,1,8,0.8411642304726357
be38347662f84cfaaf138568c7af23dc,post,Wednesday,7.860794932169856,0,3,4,4,11,1.3993495689581121
be38347662f84cfaaf138568c7af23dc,pre,Friday,7.828931424264525,0,3,5,6,14,1.7882389359816375
be38347662f84cfaaf138568c7af23dc,pre,Sunday,7.095544655530027,0,3,2,2,7,0.9865345565184256
be38347662f84cfaaf138568c7af23dc,pre,Thursday,5.478189665160187,0,2,4,2,8,1.4603364412294537
be38347662f84cfaaf138568c7af23dc,pre,Tuesday,8.094508291473915,0,4,9,1,14,1.7295676890894585
be38347662f84cfaaf138568c7af23dc,pre,Wednesday,4.147648668202406,0,1,2,2,5,1.20550229780359
c24fe9f453af4415b33f95cce2f5b6be,post,Monday,5.502500684780061,0,3,3,2,8,1.4538844169757275
c24fe9f453af4415b33f95cce2f5b6be,post,Sunday,8.487290305357403,0,7,2,1,10,1.1782323498098957
c24fe9f453af4415b33f95cce2f5b6be,post,Thursday,3.2809497169258623,0,0,1,3,4,1.2191591902078474
c24fe9f453af4415b33f95cce2f5b6be,post,Tuesday,10.332113111747317,0,6,3,5,14,1.354998716001512
c24fe9f453af4415b33f95cce2f5b6be,post,Wednesday,6.189233676756737,0,7,1,1,9,1.4541380193478415
c24fe9f453af4415b33f95cce2f5b6be,pre,Friday,2.249975545390596,0,1,1,0,2,0.888898550074152
c24fe9f453af4415b33f95cce2f5b6be,pre,Monday,4.084500482259925,0,2,2,0,4,0.9793119176685294
c24fe9f453af4415b33f95cce2f5b6be,pre,Saturday,0.0,0,0,0,0,0,0.0
c24fe9f453af4415b33f95cce2f5b6be,pre,Sunday,2.3979220775026047,0,1,2,1,4,1.6681109188360002
c24fe9f453af4415b33f95cce2f5b6be,pre,Thursday,8.28809052098715,0,5,6,1,12,1.447860634438479
c24fe9f453af4415b33f95cce2f5b6be,pre,Tuesday,8.17820904789491,0,2,6,0,8,0.9782092819037462
c24fe9f453af4415b33f95cce2f5b6be,pre,Wednesday,6.218821053782397,0,3,2,2,7,1.1256152797229109
c8c0ef6adf474887bd7c089f111f50a5,post,Saturday,1.6021243488619603,0,2,0,0,2,1.2483425530737757
c8c0ef6adf474887bd7c089f111f50a5,post,Sunday,2.188669043002605,0,1,1,0,2,0.9137973630111876
c8c0ef6adf474887bd7c089f111f50a5,post,Thursday,6.847470770306984,0,1,6,1,8,1.1683145891897464
c8c0ef6adf474887bd7c089f111f50a5,post,Tuesday,3.555660434079593,0,3,2,1,6,1.687450225137469
c8c0ef6adf474887bd7c089f111f50a5,post,Wednesday,3.519589926434059,0,3,3,3,9,2.5571160811675937
c8c0ef6adf474887bd7c089f111f50a5,pre,Friday,5.6935760376562925,0,5,2,4,11,1.9320019487309854
c8c0ef6adf474887bd7c089f111f50a5,pre,Sunday,19.959322725998046,0,15,13,9,37,1.853770316154345
c8c0ef6adf474887bd7c089f111f50a5,pre,Thursday,3.5822826506022367,0,1,7,1,9,2.5123645669017662
c8c0ef6adf474887bd7c089f111f50a5,pre,Tuesday,5.040250029930171,0,3,6,0,9,1.7856257024068087
c8c0ef6adf474887bd7c089f111f50a5,pre,Wednesday,3.031059079171646,0,0,4,1,5,1.6495884340751428
c9b8af1f0749489b976e32ed54081f5b,post,Friday,8.316145260782204,0,7,4,1,12,1.442976237631436
c9b8af1f0749489b976e32ed54081f5b,post,Saturday,6.372659929348673,0,8,2,5,15,2.3538051875197263
c9b8af1f0749489b976e32ed54081f5b,post,Wednesday,14.599308420881862,0,8,6,1,15,1.0274459287773534
c9b8af1f0749489b976e32ed54081f5b,pre,Friday,4.230538719807041,0,3,1,1,5,1.1818825759921316
c9b8af1f0749489b976e32ed54081f5b,pre,Monday,5.14011547194652,0,1,1,1,3,0.5836444757658187
c9b8af1f0749489b976e32ed54081f5b,pre,Saturday,3.667827919273983,0,1,6,1,8,2.1811274073031037
c9b8af1f0749489b976e32ed54081f5b,pre,Sunday,4.284877787245039,0,2,3,1,6,1.4002733095119846
c9b8af1f0749489b976e32ed54081f5b,pre,Thursday,3.83857671224362,0,1,2,0,3,0.7815396760031199
c9b8af1f0749489b976e32ed54081f5b,pre,Wednesday,3.00004138921383,0,5,3,3,11,3.6666160805476697
cb97d355264744fa81623e52507508a8,post,Friday,10.070688518168513,0,4,4,2,10,0.9929807661074033
cb97d355264744fa81623e52507508a8,post,Sunday,3.594087823152095,0,2,1,0,3,0.834704144031999
cb97d355264744fa81623e52507508a8,post,Thursday,2.653624867036529,0,4,1,2,7,2.6379011166779365
cb97d355264744fa81623e52507508a8,post,Tuesday,18.87307862834303,0,6,6,5,17,0.9007539434753323
cb97d355264744fa81623e52507508a8,pre,Friday,1.940929666962852,0,3,2,1,6,3.0913021229608706
cb97d355264744fa81623e52507508a8,pre,Monday,18.85043783493637,0,9,13,8,30,1.59147497064496
cb97d355264744fa81623e52507508a8,pre,Sunday,15.143446598578073,0,8,6,11,25,1.65087913357501
cb97d355264744fa81623e52507508a8,pre,Thursday,6.015177894793239,0,4,0,2,6,0.9974767338458307
cb97d355264744fa81623e52507508a8,pre,Tuesday,7.469376605200008,0,6,4,2,12,1.6065597752355767
ccb1eb9bc89a47399d56c685a660e62a,post,Friday,7.135587830332659,0,4,2,1,7,0.9809983657188986
ccb1eb9bc89a47399d56c685a660e62a,post,Monday,11.691984727453004,0,8,2,2,12,1.0263441391454926
ccb1eb9bc89a47399d56c685a660e62a,post,Thursday,5.698737940173103,0,6,5,2,13,2.2812068455292254
ccb1eb9bc89a47399d56c685a660e62a,post,Tuesday,14.886593170258205,0,5,3,5,13,0.8732689777519135
ccb1eb9bc89a47399d56c685a660e62a,pre,Friday,1.9237784322744815,0,2,0,2,4,2.0792415243323026
ccb1eb9bc89a47399d56c685a660e62a,pre,Monday,8.288676595521377,0,7,9,2,18,2.17163738898028
ccb1eb9bc89a47399d56c685a660e62a,pre,Saturday,6.809855801205062,0,6,6,3,15,2.2026898128071406
ccb1eb9bc89a47399d56c685a660e62a,pre,Sunday,3.4742509227486886,0,4,0,0,4,1.1513273188786721
ccb1eb9bc89a47399d56c685a660e62a,pre,Tuesday,12.579582116473553,0,5,4,4,13,1.033420655760567
ccb1eb9bc89a47399d56c685a660e62a,pre,Wednesday,3.332453358178552,0,1,5,1,7,2.1005545307394944
d146883c489d426a9c60d213372852c1,post,Friday,7.73126254160881,0,4,3,9,16,2.0695196824438113
d146883c489d426a9c60d213372852c1,post,Monday,9.001485373935399,0,3,2,2,7,0.7776494333112091
d146883c489d426a9c60d213372852c1,post,Sunday,10.693204828739336,0,3,9,2,14,1.3092426661811654
d146883c489d426a9c60d213372852c1,post,Tuesday,4.455025589817367,0,3,2,0,5,1.1223280089407912
d146883c489d426a9c60d213372852c1,pre,Friday,5.228769182895003,0,2,4,2,8,1.5299967774769234
d146883c489d426a9c60d213372852c1,pre,Saturday,9.109163066236688,0,4,4,1,9,0.988016125582239
d146883c489d426a9c60d213372852c1,pre,Thursday,11.906040610431262,0,9,5,3,17,1.4278466331708761
d146883c489d426a9c60d213372852c1,pre,Tuesday,2.600355552523558,0,3,0,0,3,1.1536883858396212
d445010c29f14ccdb0f8b06d2c796c9a,post,Monday,8.373439952050722,0,6,4,1,11,1.3136775402928653
d445010c29f14ccdb0f8b06d2c796c9a,post,Thursday,7.572121745876219,0,1,4,6,11,1.4526971923015641
d445010c29f14ccdb0f8b06d2c796c9a,post,Wednesday,5.532852224268252,0,0,1,1,2,0.36147721264406446
d445010c29f14ccdb0f8b06d2c796c9a,pre,Friday,3.665668512022877,0,2,0,1,3,0.8184046075525984
d445010c29f14ccdb0f8b06d2c796c9a,pre,Monday,6.47511788850624,0,3,6,2,11,1.6988107690712047
d445010c29f14ccdb0f8b06d2c796c9a,pre,Saturday,9.211304177903212,0,5,6,6,17,1.845558421659868
d445010c29f14ccdb0f8b06d2c796c9a,pre,Sunday,2.4896811818565308,0,0,2,1,3,1.2049735612183603
d445010c29f14ccdb0f8b06d2c796c9a,pre,Thursday,3.855720431970823,0,2,2,1,5,1.2967745167779934
d445010c29f14ccdb0f8b06d2c796c9a,pre,Tuesday,4.059963491366737,0,1,1,2,4,0.9852305343399649
d5063378b07548a2854773eaea2e9375,post,Wednesday,10.881016132654445,0,14,10,4,28,2.573289080600724
d5063378b07548a2854773eaea2e9375,pre,Friday,3.6112654833136713,0,0,2,0,2,0.5538224783642366
d5063378b07548a2854773eaea2e9375,pre,Monday,5.336052884339432,0,3,3,1,7,1.311831076589218
d5063378b07548a2854773eaea2e9375,pre,Sunday,3.674554145160717,0,1,3,0,4,1.0885674402887453
d5063378b07548a2854773eaea2e9375,pre,Thursday,5.296133058563224,0,2,0,1,3,0.5664510250831695
d5063378b07548a2854773eaea2e9375,pre,Tuesday,2.415049402073819,0,4,1,2,7,2.898491432096194
defc65ca43d64c62845ea1d40df07d1b,post,Monday,1.7154511615582977,0,0,0,1,1,0.5829370269519131
defc65ca43d64c62845ea1d40df07d1b,post,Saturday,6.670439932118311,0,6,3,2,11,1.6490666450701046
defc65ca43d64c62845ea1d40df07d1b,post,Sunday,4.352251253605298,0,0,3,1,4,0.9190645867897672
defc65ca43d64c62845ea1d40df07d1b,post,Tuesday,7.93639026389783,0,5,3,3,11,1.386020550178631
defc65ca43d64c62845ea1d40df07d1b,post,Wednesday,4.917190628191019,0,4,2,0,6,1.2202089472799909
defc65ca43d64c62845ea1d40df07d1b,pre,Saturday,18.723637909815956,0,11,14,12,37,1.9761117031964486
defc65ca43d64c62845ea1d40df07d1b,pre,Sunday,2.856353426242571,0,2,2,4,8,2.8007738560993514
defc65ca43d64c62845ea1d40df07d1b,pre,Thursday,10.879390026736267,0,4,2,5,11,1.0110860970116275
defc65ca43d64c62845ea1d40df07d1b,pre,Wednesday,2.650556149216441,0,3,0,0,3,1.1318379355543409
e39a0bdcbfb5443686624508bd8b119f,post,Friday,4.03268343470708,0,3,1,1,5,1.2398692039567898
e39a0bdcbfb5443686624508bd8b119f,post,Thursday,10.863877950188318,0,3,2,2,7,0.644337135606228
e39a0bdcbfb5443686624508bd8b119f,post,Tuesday,8.943532141855943,0,1,3,4,8,0.8945011739332618
e39a0bdcbfb5443686624508bd8b119f,post,Wednesday,7.972652929539091,0,3,7,3,13,1.6305739275109203
e39a0bdcbfb5443686624508bd8b119f,pre,Friday,4.101841829974912,0,1,4,1,6,1.4627575242306936
e39a0bdcbfb5443686624508bd8b119f,pre,Monday,19.225640008912297,0,7,15,7,29,1.5084023203678354
e39a0bdcbfb5443686624508bd8b119f,pre,Sunday,2.471651578608032,0,2,0,0,2,0.8091755396714719
e39a0bdcbfb5443686624508bd8b119f,pre,Thursday,4.161737795549374,0,2,2,0,4,0.961136956844725
e95be163176b4df699e16c8619b791a1,post,Monday,3.1419611316835434,0,3,1,0,4,1.2730902237026394
e95be163176b4df699e16c8619b791a1,post,Sunday,9.63086238134211,0,4,1,6,11,1.1421614767656034
e95be163176b4df699e16c8619b791a1,post,Thursday,19.22264431316782,0,11,1,3,15,0.780329685948814
e95be163176b4df699e16c8619b791a1,post,Tuesday,10.524755823578065,0,3,2,3,8,0.7601126462314702
e95be163176b4df699e16c8619b791a1,post,Wednesday,2.564392418430354,0,0,2,2,4,1.5598236725595884
e95be163176b4df699e16c8619b791a1,pre,Friday,5.208476806018868,0,3,2,1,6,1.1519682670116635
e95be163176b4df699e16c8619b791a1,pre,Saturday,2.186807496522774,0,3,0,1,4,1.8291504882621674
e95be163176b4df699e16c8619b791a1,pre,Sunday,12.628659153891878,0,7,4,3,14,1.108589584167018
e95be163176b4df699e16c8619b791a1,pre,Thursday,7.115829497157145,0,6,3,1,10,1.4053175394372663
e95be163176b4df699e16c8619b791a1,pre,Tuesday,11.416416129769662,0,3,6,3,12,1.051117957123915
e95be163176b4df699e16c8619b791a1,pre,Wednesday,4.8975954040414,0,2,1,3,6,1.225090989559676
eaba5b5556044f659394037fb4712484,post,Friday,7.1156100620366844,0,7,2,5,14,1.9675052283560368
eaba5b5556044f659394037fb4712484,post,Monday,4.631539421832938,0,5,1,2,8,1.7272874678099983
eaba5b5556044f659394037fb4712484,post,Saturday,4.192266841863811,0,3,1,0,4,0.9541377376211262
eaba5b5556044f659394037fb4712484,post,Sunday,15.965208821393533,0,18,9,11,38,2.3801755695847606
eaba5b5556044f659394037fb4712484,post,Thursday,3.883497086127383,0,0,0,2,2,0.514999742666061
eaba5b5556044f659394037fb4712484,post,Tuesday,5.284729953623433,0,2,0,0,2,0.37844885501267966
eaba5b5556044f659394037fb4712484,pre,Friday,10.762673174968233,0,12,4,3,19,1.7653606767684906
eaba5b5556044f659394037fb4712484,pre,Saturday,4.678132344670567,0,4,1,1,6,1.2825631166325027
eaba5b5556044f659394037fb4712484,pre,Sunday,8.976128394395747,0,5,5,3,13,1.4482858788112434
eaba5b5556044f659394037fb4712484,pre,Tuesday,12.9840748341222,0,12,9,4,25,1.9254356062628275
eaba5b5556044f659394037fb4712484,pre,Wednesday,3.780138450883304,0,3,1,2,6,1.5872434509899978
f2cecf111d2646248776c284ed8266cc,post,Friday,5.33337308868599,0,4,2,1,7,1.3124902165291095
f2cecf111d2646248776c284ed8266cc,post,Sunday,7.622068000999027,0,3,1,4,8,1.049583918557462
f2cecf111d2646248776c284ed8266cc,post,Thursday,2.251847281665084,0,0,0,0,0,0.0
f2cecf111d2646248776c284ed8266cc,post,Tuesday,1.4444037606225852,0,1,1,2,4,2.7693087688139704
f2cecf111d2646248776c284ed8266cc,post,Wednesday,5.4603215134718,0,4,5,1,10,1.831393989406636
f2cecf111d2646248776c284ed8266cc,pre,Monday,11.08668865276554,0,6,6,7,19,1.7137668960569674
f2cecf111d2646248776c284ed8266cc,pre,Thursday,19.461952321646447,0,14,9,4,27,1.3873222764999482
f2cecf111d2646248776c284ed8266cc,pre,Tuesday,9.626536753712113,0,5,2,5,12,1.2465542185119327
f2cecf111d2646248776c284ed8266cc,pre,Wednesday,3.3048533996949963,0,1,5,0,6,1.8155116957846718
fab5202d978a4f2bb68c23bbd5037da8,post,Friday,2.520501405892253,0,1,0,1,2,0.7934929118962358
fab5202d978a4f2bb68c23bbd5037da8,post,Saturday,11.802878580873616,0,4,8,4,16,1.3556015077480976
fab5202d978a4f2bb68c23bbd5037da8,post,Thursday,6.790428402839195,0,2,1,0,3,0.44179834055030287
fab5202d978a4f2bb68c23bbd5037da8,post,Wednesday,8.455377286967847,0,2,4,2,8,0.94614346923706
fab5202d978a4f2bb68c23bbd5037da8,pre,Monday,4.752475648890387,0,6,0,2,8,1.68333319116908
fab5202d978a4f2bb68c23bbd5037da8,pre,Saturday,3.1083386066737377,0,1,0,1,2,0.6434305437978711
fab5202d978a4f2bb68c23bbd5037da8,pre,Thursday,3.838649979775397,0,6,1,0,7,1.8235577707998207
fab5202d978a4f2bb68c23bbd5037da8,pre,Tuesday,2.861110164453349,0,2,1,1,4,1.398058715003814
fde2feb5cf7b4ac3a7a7b937a80f78b5,post,Friday,4.451759635569866,0,0,1,1,2,0.44926055396609066
fde2feb5cf7b4ac3a7a7b937a80f78b5,post,Monday,6.325561673301507,0,4,0,1,5,0.7904436409344728
fde2feb5cf7b4ac3a7a7b937a80f78b5,post,Saturday,5.060009122549825,0,2,3,1,6,1.185768613195009
fde2feb5cf7b4ac3a7a7b937a80f78b5,post,Sunday,3.2645680945806346,0,1,1,0,2,0.6126384691806894
fde2feb5cf7b4ac3a7a7b937a80f78b5,post,Wednesday,11.910179491976816,0,9,3,5,17,1.4273504451760695
fde2feb5cf7b4ac3a7a7b937a80f78b5,pre,Friday,5.026026875052269,0,6,1,0,7,1.3927502128462461
fde2feb5cf7b4ac3a7a7b937a80f78b5,pre,Saturday,14.752410926613095,0,9,9,9,27,1.8302093220093583
fde2feb5cf7b4ac3a7a7b937a80f78b5,pre,Thursday,5.806027949628373,0,3,3,1,7,1.2056435244077752
fde2feb5cf7b4ac3a7a7b937a80f78b5,pre,Tuesday,2.5098376360236605,0,0,1,0,1,0.3984321478198492
fde2feb5cf7b4ac3a7a7b937a80f78b5,pre,Wednesday,4.908164789735643,0,3,3,2,8,1.6299371236944318
ff33bebe43c54354babd0cc0fa57a873,post,Monday,7.239815153506715,0,2,3,0,5,0.6906253673587472
ff33bebe43c54354babd0cc0fa57a873,post,Saturday,3.858738493377517,0,0,0,1,1,0.25915205233944466
ff33bebe43c54354babd0cc0fa57a873,post,Sunday,1.4281605305557823,0,1,0,0,1,0.7002013979554809
ff33bebe43c54354babd0cc0fa57a873,post,Thursday,7.08060530367103,0,3,2,3,8,1.129846906711817
ff33bebe43c54354babd0cc0fa57a873,post,Wednesday,2.5980574999875268,0,2,2,0,4,1.539611806135624
ff33bebe43c54354babd0cc0fa57a873,pre,Friday,4.040529835182478,0,0,4,2,6,1.4849537671410433
ff33bebe43c54354babd0cc0fa57a873,pre,Saturday,10.693230198278957,0,6,6,4,16,1.4962737828813553
ff33bebe43c54354babd0cc0fa57a873,pre,Sunday,7.536392683417885,0,4,6,1,11,1.459584241702664
ff33bebe43c54354babd0cc0fa57a873,pre,Thursday,3.587892029071397,0,0,0,3,3,0.8361455628240985
ff33bebe43c54354babd0cc0fa57a873,pre,Wednesday,7.653847128369215,0,4,0,1,5,0.6532662484814139
